1111111111111111111111111111111111111111
1000000000000000000000000E00000000000001
1011111111111111111111111111111111111001
1000000000000000000000000000000000000001
1000111111111111000000001111111110000001
100000000000000000C000000000000000000001
1000000C00000000000000000C00000000000001
10000000000000000000P00000000000C0000001
100000000C0000000C0000000000000000000001
1000000000000000000000C00000000000000001
1111111111111111111111111111111111111111