111111111111
1P0000000111
111111110001
100C00000C01
111110111111
1C0000000001
111111111101
100000C00001
1E1111111111
111111111111